5 5 5 5 5 5 5 5 5 5 5 5 5 5 5 	 
5 5 5 5 5 5 5 5 5 5 5 5 5 5 5 	 
4 5 4 5 4 0 0 0 0 0 4 5 4 5 4 	 
1 1 4 1 1 0 0 1 0 0 1 1 4 1 1 	 
3 4 3 4 3 0 0 0 0 0 3 4 3 4 3 	 
3 1 1 1 3 3 3 3 3 3 3 1 1 1 3 	 
2 3 2 3 2 3 2 3 2 3 2 3 2 3 2 	 
2 2 2 2 2 2 2 2 2 2 2 2 2 2 2